"filename", "language", "Python", "Markdown", "comment", "blank", "total"
"/home/tanner/Documents/repos/branch/rootflow/API.md", "Markdown", 0, 30, 0, 15, 45
"/home/tanner/Documents/repos/branch/rootflow/README.md", "Markdown", 0, 50, 0, 13, 63
"/home/tanner/Documents/repos/branch/rootflow/examples/functional_datasets.py", "Python", 11, 0, 6, 7, 24
"/home/tanner/Documents/repos/branch/rootflow/examples/hyperparameter_tuning.py", "Python", 9, 0, 0, 5, 14
"/home/tanner/Documents/repos/branch/rootflow/examples/nlp_classification.py", "Python", 35, 0, 1, 6, 42
"/home/tanner/Documents/repos/branch/rootflow/rootflow/__init__.py", "Python", 2, 0, 0, 2, 4
"/home/tanner/Documents/repos/branch/rootflow/rootflow/datasets/__init__.py", "Python", 0, 0, 0, 2, 2
"/home/tanner/Documents/repos/branch/rootflow/rootflow/datasets/base/__init__.py", "Python", 0, 0, 0, 1, 1
"/home/tanner/Documents/repos/branch/rootflow/rootflow/datasets/base/dataset.py", "Python", 221, 0, 234, 50, 505
"/home/tanner/Documents/repos/branch/rootflow/rootflow/datasets/base/display_utils.py", "Python", 131, 0, 76, 31, 238
"/home/tanner/Documents/repos/branch/rootflow/rootflow/datasets/base/functional.py", "Python", 121, 0, 134, 24, 279
"/home/tanner/Documents/repos/branch/rootflow/rootflow/datasets/base/utils.py", "Python", 77, 0, 105, 17, 199
"/home/tanner/Documents/repos/branch/rootflow/rootflow/datasets/examples.py", "Python", 105, 0, 19, 20, 144
"/home/tanner/Documents/repos/branch/rootflow/rootflow/linear/__init__.py", "Python", 0, 0, 0, 1, 1
"/home/tanner/Documents/repos/branch/rootflow/rootflow/linear/preferences.py", "Python", 0, 0, 0, 1, 1
"/home/tanner/Documents/repos/branch/rootflow/rootflow/loss/__init__.py", "Python", 0, 0, 0, 1, 1
"/home/tanner/Documents/repos/branch/rootflow/rootflow/loss/sequential.py", "Python", 0, 0, 1, 0, 1
"/home/tanner/Documents/repos/branch/rootflow/rootflow/models/__init__.py", "Python", 0, 0, 0, 1, 1
"/home/tanner/Documents/repos/branch/rootflow/rootflow/models/nlp/__init__.py", "Python", 0, 0, 0, 1, 1
"/home/tanner/Documents/repos/branch/rootflow/rootflow/models/nlp/transformers.py", "Python", 65, 0, 5, 10, 80
"/home/tanner/Documents/repos/branch/rootflow/rootflow/models/nlp/utils.py", "Python", 34, 0, 2, 5, 41
"/home/tanner/Documents/repos/branch/rootflow/rootflow/training/__init__.py", "Python", 0, 0, 0, 1, 1
"/home/tanner/Documents/repos/branch/rootflow/rootflow/training/base.py", "Python", 18, 0, 0, 5, 23
"/home/tanner/Documents/repos/branch/rootflow/rootflow/training/metrics/__init__.py", "Python", 1, 0, 0, 1, 2
"/home/tanner/Documents/repos/branch/rootflow/rootflow/training/metrics/basic.py", "Python", 42, 0, 1, 10, 53
"/home/tanner/Documents/repos/branch/rootflow/rootflow/training/nlp.py", "Python", 25, 0, 0, 8, 33
"/home/tanner/Documents/repos/branch/rootflow/rootflow/training/supervised.py", "Python", 21, 0, 0, 6, 27
"/home/tanner/Documents/repos/branch/rootflow/rootflow/training/utils.py", "Python", 4, 0, 0, 3, 7
"/home/tanner/Documents/repos/branch/rootflow/setup.py", "Python", 20, 0, 1, 3, 24
"/home/tanner/Documents/repos/branch/rootflow/tests/datasets/base/test_concat_dataset_view.py", "Python", 116, 0, 0, 38, 154
"/home/tanner/Documents/repos/branch/rootflow/tests/datasets/base/test_data_item.py", "Python", 29, 0, 0, 11, 40
"/home/tanner/Documents/repos/branch/rootflow/tests/datasets/base/test_dataset.py", "Python", 128, 0, 0, 45, 173
"/home/tanner/Documents/repos/branch/rootflow/tests/datasets/base/test_dataset_view.py", "Python", 119, 0, 0, 42, 161
"/home/tanner/Documents/repos/branch/rootflow/tests/datasets/test_display_utils.py", "Python", 15, 0, 0, 15, 30
"/home/tanner/Documents/repos/branch/rootflow/tests/datasets/test_utils.py", "Python", 64, 0, 2, 14, 80
"/home/tanner/Documents/repos/branch/rootflow/tests/models/nlp/test_utils.py", "Python", 13, 0, 2, 3, 18
"/home/tanner/Documents/repos/branch/rootflow/tests/models/nlp/transformers/test_classification_head.py", "Python", 0, 0, 0, 1, 1
"/home/tanner/Documents/repos/branch/rootflow/tests/models/nlp/transformers/test_classification_transformer.py", "Python", 0, 0, 0, 1, 1
"/home/tanner/Documents/repos/branch/rootflow/tests/models/nlp/transformers/test_tokenizer.py", "Python", 0, 0, 0, 1, 1
"Total", "-", 1426, 80, 589, 421, 2516